,id,level,color_class,position,chunk_no,word,lemma,pre_verb,morph,colspan,wordlenth,aux_inf,subminp,maxp,endposition
0,0,1,mauve_back,0,1,tataḥ,tatas,,adv.,5,5,,0,5,5
1,1,1,mauve_back,0,1,tataḥ,tad,,tasil,5,5,,0,5,5
2,2,1,deep_sky_back,6,2,viśvāmitraḥ,viśvāmitra,,m. sg. nom.,11,11,,0,11,17
3,3,1,carmin_back,18,3,krāma,kram,,imp. [1] ac. sg. 2,5,5,,0,5,23
4,4,1,deep_sky_back,23,3,lakṣmaṇau,lakṣmaṇa,,m. du. acc.,8,9,,5,13,31
5,5,1,deep_sky_back,23,3,lakṣmaṇau,lakṣmaṇa,,m. du. nom.,8,9,,5,13,31
6,6,1,deep_sky_back,32,4,prakṛtiḥ,prakṛti,,f. sg. nom.,8,8,,0,8,40
7,7,1,yellow_back,40,4,a,a,,iic.,1,1,,8,9,41
8,8,1,deep_sky_back,41,4,maṇī,maṇi,,m. du. acc.,4,4,,9,13,45
9,9,1,deep_sky_back,41,4,maṇī,maṇi,,m. du. nom.,4,4,,9,13,45
10,10,1,cyan_back,45,4,yam,ya,,n. sg. acc.,3,3, sence of lemma = 2,13,16,48
11,11,1,cyan_back,45,4,yam,ya,,n. sg. nom.,3,3, sence of lemma = 2,13,16,48
12,12,1,deep_sky_back,49,5,siddhā,siddha,,f. sg. nom.,5,6,{ pp. }[sidh_1 sence of lemma = 1,0,5,54
13,13,1,deep_sky_back,49,5,siddhā,siddha,,f. sg. nom.,5,6,{ pp. }[sidh_2 sence of lemma = 2,0,5,54
14,14,1,deep_sky_back,54,5,śramam,śrama,,m. sg. acc.,6,6,,5,11,60
15,15,1,carmin_back,61,6,anayat,nī,,impft. [1] ac. sg. 3,6,6, sence of lemma = 1,0,6,67
16,16,2,deep_sky_back,0,1,tataḥ,tata,,m. sg. nom.,5,5, sence of lemma = 2,0,5,5
17,17,2,yellow_back,6,2,viśva,viśva,,iic.,5,5,,0,5,11
18,18,2,deep_sky_back,11,2,mitraḥ,mitra,,m. sg. nom.,6,6,,5,11,17
19,19,2,lawngreen_back,23,3,lakṣmaṇau,lakṣmaṇa,,m. du. voc.,8,9,,5,13,31
20,20,2,yellow_back,32,4,prakṛti,prakṛti,,iic.,7,7,,0,7,39
21,21,2,deep_sky_back,39,4,ramaṇīyam,ramaṇīya,,n. sg. acc.,9,9,{ pfp. [2,7,16,48
22,22,2,deep_sky_back,39,4,ramaṇīyam,ramaṇīya,,n. sg. nom.,9,9,{ pfp. [2,7,16,48
23,23,2,deep_sky_back,39,4,ramaṇīyam,ramaṇīya,,m. sg. acc.,9,9,{ pfp. [2,7,16,48
24,24,2,deep_sky_back,39,4,ramaṇīyam,ramaṇīya,,n. sg. acc.,9,9,{ ca. pfp. [2,7,16,48
25,25,2,deep_sky_back,39,4,ramaṇīyam,ramaṇīya,,n. sg. nom.,9,9,{ ca. pfp. [2,7,16,48
26,26,2,deep_sky_back,39,4,ramaṇīyam,ramaṇīya,,m. sg. acc.,9,9,{ ca. pfp. [2,7,16,48
27,27,2,yellow_back,49,5,siddha,siddha,,iic.,5,6,{ pp. }[sidh_1 sence of lemma = 1,0,5,54
28,28,2,yellow_back,49,5,siddha,siddha,,iic.,5,6,{ pp. }[sidh_2 sence of lemma = 2,0,5,54
29,29,2,carmin_back,54,5,śramam,śram,,inj. [2] ac. sg. 1,6,6,,5,11,60
30,30,2,yellow_back,61,6,an,an,,iic.,2,2, sence of lemma = 1,0,2,63
31,31,2,deep_sky_back,63,6,ayat,ayat,,n. sg. acc.,4,4,{ ppr. [1,2,6,67
32,32,2,deep_sky_back,63,6,ayat,ayat,,n. sg. nom.,4,4,{ ppr. [1,2,6,67
33,33,3,deep_sky_back,0,1,tataḥ,tata,,m. sg. nom.,5,5,{ pp. }[tan_1 sence of lemma = 1,0,5,5
34,34,3,yellow_back,6,2,viśvā,viśvā,,iic.,5,5,,0,5,11
35,35,3,cyan_back,13,2,traḥ,tra,,m. sg. nom.,4,4,,7,11,17
36,36,3,yellow_back,39,4,ramaṇī,ramaṇī,,iic.,6,6,,7,13,45
37,37,3,yellow_back,39,4,ramaṇī,ramaṇa,,iic.,6,6,,7,13,45
38,38,3,light_blue_back,45,4,yam,yad,,m. sg. acc.,3,3,,13,16,48
39,39,3,deep_sky_back,53,5,āśramam,āśrama,,m. sg. acc.,7,7,,4,11,60
40,40,3,deep_sky_back,53,5,āśramam,āśrama,,n. sg. acc.,7,7,,4,11,60
41,41,3,deep_sky_back,53,5,āśramam,āśrama,,n. sg. nom.,7,7,,4,11,60
42,42,3,yellow_back,61,6,a,a,,iic.,1,1,,0,1,62
43,43,3,deep_sky_back,62,6,nayat,nayat,,n. sg. acc.,5,5,{ ppr. [1,1,6,67
44,44,3,deep_sky_back,62,6,nayat,nayat,,n. sg. nom.,5,5,{ ppr. [1,1,6,67
45,45,4,light_blue_back,6,2,viśvā,viśva,,f. sg. nom.,5,5,,0,5,11
46,46,4,deep_sky_back,39,4,ramaṇī,ramaṇī,,f. sg. nom.,6,6,,7,13,45
47,47,4,deep_sky_back,39,4,ramaṇī,ramaṇa,,f. sg. nom.,6,6,,7,13,45
48,48,4,carmin_back,53,5,aśramam,śram,,aor. [2] ac. sg. 1,7,7,,4,11,60
49,49,4,carmin_back,53,5,aśramam,śram,,impft. [1] ac. sg. 1,7,7,,4,11,60
50,50,4,lawngreen_back,62,6,nayat,nayat,,n. sg. voc.,5,5,{ ppr. [1,1,6,67
51,51,5,yellow_back,6,2,viś,viś,,iic.,3,3, sence of lemma = 2,0,3,9
52,52,5,yellow_back,9,2,vāmi,vāmin,,iic.,4,4,,3,7,13
53,53,5,yellow_back,9,2,vāmi,vāma,,iic.,4,4, sence of lemma = 2,3,7,13
54,54,5,light_blue_back,44,4,iyam,idam,,f. sg. nom.,4,4,,12,16,48
55,55,5,yellow_back,53,5,a,a,,iic.,1,1,,4,5,54
56,56,5,lawngreen_back,63,6,ayat,ayat,,n. sg. voc.,4,4,{ ppr. [1,2,6,67
57,57,6,deep_sky_back,10,2,amitraḥ,amitra,,m. sg. nom.,7,7,,4,11,17
58,58,6,yellow_back,63,6,a,a,,iic.,1,1,,2,3,64
59,59,6,deep_sky_back,64,6,yat,yat,,n. sg. acc.,3,3,{ ppr. [2 sence of lemma = 2,3,6,67
60,60,6,deep_sky_back,64,6,yat,yat,,n. sg. nom.,3,3,{ ppr. [2 sence of lemma = 2,3,6,67
61,61,7,deep_sky_back,10,2,āmitraḥ,āmitra,,m. sg. nom.,7,7,,4,11,17
62,62,7,lawngreen_back,64,6,yat,yat,,n. sg. voc.,3,3,{ ppr. [2 sence of lemma = 2,3,6,67
63,63,8,yellow_back,10,2,a,a,,iic.,1,1,,4,5,11
